NO ./../assets/texture/jisookim/purple_window.xpm
SO ./../assets/texture/jisookim/purple_window.xpm
WE ./../assets/texture/jisookim/purple_window.xpm
EA ./../assets/texture/jisookim/purple_window.xpm

C 0,0,0
F 0,0,0




                                                                                                    
 11111111111111111111111111111111111111111111111111111111111111111111111111111111111111111111111111 
 1                                                                                                1 
 1                                                                                                1 
 1                                         1111111111111111111111111111111111111111               1 
 1                                                                                                1 
 1                                                                                                1 
 1                                                                                                1 
 1                      1111111111111111111111111111111                                           1 
 1                      100000000                                                                 1 
 1                      100000000                                                                 1 
 1                      100000000                                                                 1 
 1                      100000000                                                                 1 
 1                      100000000                                                                 1 
 1                      100000000                                                                 1 
 1                      100000000                                                                 1 
 1                      100000000                                                                 1 
 1                      100000000                                                                 1 
 1                      100000000                                                                 1 
 1                      100000000111111111111111111111111111111111111111111                       1 
 1                      100000000100000000000                                                     1 
 1                      100000000100000000000                                                     1 
 1                      100000000100000000000                                                     1 
 1                      100000000100000000000                                                     1 
 1                      100000000100000000000                                                     1 
 1                      100000000100000000000                                                     1 
 1                      100000000100000000000                                                     1 
 1                      100000000100000000000                                                     1 
 1                      100000000100000000000                                                     1 
 1                      100000000100000000000                                                     1 
 1                      100000000100000000000                                                     1 
 1                      100000000100000000000                                                     1 
 1                      100000000100000000000                                                     1 
 1                      100000000100000000000                                                     1 
 1                      100000000100000000000                                                     1 
 1                      100000000100000000000                                                     1 
 1                      100000000100000000000                                                     1 
 1                      100000000100000000000                                                     1 
 1                      100000000100000000000                                                     1 
 1                      100000000100000000000                                                     1 
 1                      100000000100000000000                                                     1 
 11111111111111111111111100000000100000000000111111111111111111111111111111111111111111111111111111 
 1                                                                                                1 
 1                                                                                                1 
 1                                                                                                1 
 1                                                                                                1 
 1                                                                                                1 
 1                                                                                                1 
 1                                                                                                1 
 1                                                                                                1 
 1                                                                                                1 
 1                                                                                                1 
 1                                                                                                1 
 1                                                                                                1 
 1                                                                                                1 
 1                                                                                                1 
 1                                                                                                1 
 1                                                                                                1 
 1                                                                                                1 
 1                                                                                                1 
 1                                                                                                1 
 1                                                                                                1 
 1                                                                                                1 
 1                                                                                                1 
 1                                                                                                1 
 1                                                                                                1 
 1                                                                                                1 
 1                                                                                                1 
 1                                                                                                1 
 1                                                                                                1 
 1                                                                                                1 
 1                                                                                                1 
 1                                                                                                1 
 1                                                                                                1 
 1                                                                                                1 
 1                                                                                                1 
 1                                                                                                1 
 1                                                                                                1 
 1                                                                                                1 
 1                                                                                                1 
 1                                                                                                1 
 1                                                                                                1 
 1                                                                                                1 
 1                                                                                                1 
 1                                                                                                1 
 1                                                                                                1 
 1                                                                                                1 
 1                                                                                                1 
 1                                                                                                1 
 1                                                                                                1 
 1                                                                                                1 
 1                                                                                                1 
 1                                                                                                1 
 1                                                                                                1 
 1                                                                                                1 
 1                                                                                                1 
 1                                                                                                1 
 1                                                                                                1 
 1                                                                                                1 
 11111111111111111111111111111111111111111111111111111111111111111111111111111111111111111111111111 
                                                                                                    
