NO ./path_to_the_north_texture
SO ./path_to_the_south_texture
WE ./path_to_the_west_texture
EA ./path_to_the_east_texture

F 220,100,0
C 225,30,0



        1111111111111111111111101
        10000000001100000000000011111111111111
        10110000011100000000000000000000000001
        10010000000000000000000011111111111111   111
111111111011000001110000000000001                101
100000000011000001110111111111111                101
11110111111111011100000010001                    101
11110111111111011101010010001                    101
11000000110101011100000010001                    101
10000000000000001100000010001                    101
10000000000000001101010010001111111111111111111111011111
11000001110101011111011110N00000000000000000000000000001
11110111 1111101 101111010001111111101111111111111111111
11111111 1111111 111111111111
