NO ./assets/texture/Christmas theme/WALL1.xpm
SO ./assets/texture/Christmas theme/WALL2.xpm
WE ./assets/texture/Christmas theme/WALL3.xpm
EA ./assets/texture/Christmas theme/WALL4.xpm

DOOR ./assets/texture/Christmas theme/DOOR1.xpm
SPRITE ./assets/texture/Christmas theme/Rudolph-basic.xpm

C 19,50,255
F 72,36,19



        1111111111111111111111111
        10000000000000000000000011111111111111
        10110000000000000000000000000000000001
        10010000000000000000000011111111111111   111
111111111011000000000000000000001                101
100000000000000000000111111111111                101
10000000000000000000000010001                    101
10000000000000000001010010001                    101
10000000000000000000000010001                    101
1000000N000000000000000010101                    101
10000000000000000001010010001111111111111111111111D11111
1100000111000001110000000000D000000000000000000000000001
10000001 1000001 100000000001111111111111111111111111111
11111111 1111111 111111111111
